'd	would/should/could/did
's grasp	la poigne/l'emprise
For me	is to express its effect on you or it's benefit for you, whether it's good or bad/expresses ideal suitability of the object for your use
To me	is to express opinion/expresses your opinion of perfection in the object.
a beacon	un phare
a bench	un banc
a bother	un ennui/un embêtement
a brake	un frein
a brewery	une brasserie
a bud	un bourgeon
a claw	une griffe
a clue	un indice
a crack of smile	un éclat de sourire
a display	un écran/un affichage
a duck	un canard
a few at a time	quelques-uns à la fois
a fitting punishment	une punition appropriée
a friend of mine's	un de mes amis
a friend of mine's an aspiring actor	un de mes amis est un acteur en herbe
a fuss	une histoire
a good for nothing	un bon a rien
a haul	un butin
a hawk	un falcon
a hedgehog	un hérisson
a hold of	une prise de
a kettle	une bouilloire
a knack	un talent
a lamp post	un lampadaire
a lighthouse	un phare
a little chat	une petite conversation
a little run down	un peu délabré
a mole	une taupe
a package	un colis/un paquet
a parcel	une parcelle/un colis
a pedestrian	un piéton
a place	un lieu/un endroit
a plot	terrain/parcelle/complot/une intrigue
a posting	une annonce
a real hard-on for cleanliness	un vrai dur à cuire pour la propreté
a scratch	une égratignure
a screw loose	une case en moins
a sign	un panneau/un signe
a swan	un cygne
a sweat	une sueur
a traffic light	un feu tricolor
a trafic jam	un embouteillage
a while yet	encore un moment
a while yet	un certain temps encore/encore un moment
a whole	un ensemble
a whole bunch	tout un tas
a wink	un clin d'oeil
a witness	un témoin
a wonder	merveille
abhor	abhorrer/détester/horreur
accounts	compte/comptabilité
accustom	habituer/accoutumer
accustomed	accoutumé/habitué
acknowledge	reconnaître
acquaint	familiariser
acquainted	connaissance
across	de l'autre côté
add up to	ajouter à
afford	permettre
afford	s'offrir/se permettre
afloat	à flot
afore	avant
aforementioned	susmentionné
agonizing	angoissant
ahead	avant/devant/en avant/en avance
airborne	aéroporté
akin	proche
akin to a yarn ball in the paws of a kitten	semblable à une pelote de laine dans les pattes d'un chaton
alas	Hélas
albeit	quoique
albeit	quoique/bien que
all manner	de toutes les manières
all manner of wondrous	toutes sortes de merveilles
all of sudden	soudainement/tout d'un coup
all on behalf	tout au nom
all people	tout le monde
all the people	toutes les personnes
all's Well That Ends Well	Tout est bien qui finit bien
along	le long
aloud	à haute voix
although	bien que/même si
although	même si
amidst	au milieu de
among	parmi
amongst	parmi
an all-out	un tout-en-un
an egg yolk	un jaune d'oeuf
an enigma	une énigme
an evidence	une évidence
and then some	et puis certains
anger	colère
anguish	angoisse
another plot	un autre complot
antsy	anxieux
anyway	de toute façon
appointment	rendez vous
are divided up	sont réparties
are you two meant	Êtes-vous deux faits l'un pour l'autre ?
arise	survenir/surgir
arrogation	arrogance
arrêter de tergiverser	arrêter de tergiverser
as a whole	dans son ensemble
as long as	aussi longtemps que
as long as i get it all today	tant que je reçois tout aujourd'hui
as much as they may want it	autant qu'ils le voudront
as such	En tant que tel
as we go	comme nous allons/au fur et à mesure
as well as how it might be wielded	ainsi que la façon dont il pourrait être utilisé
as wide	aussi large
aside	de côté/à part
asleep	endormi
aspire	aspirer
aspiring	aspirant/en herbe
aspiring	en herbe
assess	évaluer/estimer
assumption	supposition/hypothèse
astonish	étonner
astonishing	étonnant
astray	égaré
at a stalemate	dans une impasse
at a time	à la fois
at last	enfin
at least	au moins
at least we got to see	au moins on a pu voir
at the fact that	au fait que
at the time	a l'époque
atone	expier
attorneys	avocats
autant difficile au début qu'à la fin	as difficult at the beginning as at the end
automne	autumn/fall
awfully	terriblement
back then	à l'époque
back up	sauvegarde/sauvegarder
back up	sauvegarder
backfiring	retour de flamme
baker	boulanger
bare	nu/dépouillé
bargains	bonnes affaires
bartender	barman
bashful	timide
bat an eyelid	battre une paupière
bath	bain/baingoire/baigner
bathed	baigné
bawling	brailler
be in touch	être en contact
be my guest	soit mon invité
be poise	se poser/être poser
be poised	être prêt
be smooth sailing	naviguer en douceur
be up to	être prêt à
be up to it	être à la hauteur
beacon	balise/phare
bead	perle
bear	ours/porter/supporter/assumer
bear witness	témoigner
bearer	porteur
beckon	faire signe
become well versed	bien s'y connaître/se familiariser
been back	été de retour
befits	convient
behalf	au nom de
behaviour	comportement
behold	voici
below	ci-dessous
bemuse verbe	stupéfier/déconcerter
bemused	perplexe
bemused adj	perplex/confus
bench	banc
beneath	sous/au-dessous
besides	outre/en dehors de/par ailleurs
besides	outre/en dehors de/par ailleurs
besides that	en plus de cela/a côté de ça
bespoke	sur mesure
better than ever	mieux que jamais
beyond	au-delà
beyond hope	au-delà de l'espoir
bill	facture
bitter	amer
blanket	couverture
blasting	dynamitage
blasting agent	poudre a canon
blend	mélange
blockade	blocus
bloodstain	tâche de sang
bloom	fleur/fleurir
bloomed	fleurie
blow them up	les faire exploser
blown	soufflé
blurry	flou
boil	bouillir
boiling	ébullition
boils down to	se résume à
boldness	audace
bonds	obligations
bootstrap	amorcer
borrow	emprunter
bother	embêter
bother	ennui/déranger/embêter/gêner
brake	frein/freiner
brand	marque
brand goods	produits de marque
bravo	acclamation
brawn	muscle
breakout	éclater
brewery	brasserie
bring	apporté
bud	bourgeon/bourgeonner
buddies	copains
bulk	en gros
bunch	tas/bande/groupe
buried	enterré
bury	enterrer
bust	buste/casser/arrêter
busted	cassée
busted ass	se casser le cul
busted-ass goods	marchandises cassées
bustle	agitation
bustling	animé/vif/vivant
bustling street	rue animée
but never mind that	mais peu importe
but not to worry	mais ne vous inquiétez pas
by now	maintenant
by proceeding	en procédant
by proceeding northwest	en se dirigeant vers le nord-ouest
by spilling	en renversant
by your leave	par ta permission/à votre choix
came across	est tombé sur
can fill you in	peut vous renseigner
can i drop by	puis je passer
can you even afford to raise a child	pouvez-vous même vous permettre d'élever un enfant
cape	cap
care	soin/soucier
careless	imprudent
carry on	poursuivre
cast	jeté/plongé/lancé/moulage
cast into a deep slumber	plonger dans un profond sommeil
cast off	rejeter
catch up soon	on en reparle/se revoit bientôt
ceiling	plafond
cellar	cave
chasm	gouffre
chat up	bavarder
check in	enregistrer
check it out	Vérifiez-le
cheer	bravo
cheer up	réconforter
cheerful	de bonne humeur
cheerfully	gaiement
cheery	gai
chest out	la poitrine
child	enfant
children	enfants
chin up	tête haute
chores	corvées
cider	Cidre
clad	habillé
claw	griffe/agripper
cleanliness	propreté
clear out	évacuer/dégager
clear up	nettoyer
cliff	falaise
cloak	manteau/cape/masquer/dissimuler
cloaked	masqué
cloth	tissu/chiffon
clothe	habiller
clothes	vetements/habits
clue	indice/idée
clumsy	maladroit
coat	manteau/blouson/couche (épaisseur)
coffee	café
come in handy	être utile
come off	se détacher
comprise	composed of/comprendre/constituer
comrades	camarades
confidently	En toute confiance
congregating	se rassembler
conspicuous	visible/remarquable
contrary to	contrairement à
convey	transmettre
conveyor belt	tapis roulant
cough up	cracher
could toss	pourrait lancer
counter	compteur/comptoire/contre/contrer
course	cours/parcours/parcourir
coverage	couverture (protection)
covet	convoiter
crack of smile	sourire en coin/éclat de sourire
crevice	crevasse/fente/fissure
crevice	fente/fissure
crisp	croustillant
critters	bestioles
crop up	surgir
cross it out	rayez-le
crosswalk	passage pieton
crowds	foules
cry out	crier/s'écrier
cuffed	menotté
cull	cueillir/abattre
cull them all	abattez-les tous
cunning	rusé
cup	coupe/tasse
curl up	se pelotonner/se recroqueviller
curled up	recroquevillé
currents	courants
curtain	rideau
custodian	gardien/conservateur
custody	garde/détention
customer	client/clientèle
customers	clients
cut it out	Ça suffit
cut it out	Ça suffit!
cutting-edge	de pointe
damn trainees	maudits stagiaires
dandelion	pissenlit
daring	audacieux
day after day	jours apres jours
deed	acte
deem	considérer
deity	divinité
delicacy	délicatesse
delight	plaisir/délice/ravir
delighted	ravi
delve	creuser
demeanor	comportement/attitude/conduite
depletes	épuise
despise	mépriser
despite	en dépit/malgres
devise	élaboration/concevoir/élaborer
devised	conçue
dilly-dallying	tergiverser
diluc's theft	Le vol de Diluc
dim	faible/sombre/tamiser
disasters	catastrophes
disbelief	incrédulité
disclaimer	avertissement
dish	assiette/plat
dish it out	distribuez-le
dismissal	destitution/départ
display	écran/affichage
do me proud	rends-moi fier
does it stem	est-ce que ça vient
doll	poupée
don't anger me	ne m'énerve pas
don't bother	ne t'embête pas
don't bother racking	ne vous embêtez pas à ranger
don't bother racking your brain	ne vous embêtez pas à vous creuser la tête
don't rush it and drop your tools	ne vous précipitez pas et déposez vos outils
don't screw this up	ne gâche pas ça
don't take your eyes off it	ne le quittez pas des yeux
doomrats	rats de malheur
down the line	sur toute la ligne
downward	vers le bas
drafting up	rédaction
dragging me through	me traînant à travers
draw	dessiner/attirer/tirer
drawback	inconvénient
dreadful	terrible/épouvantable
driven	conduit/passionné
drop by	passer
drop by when	passer quand
drop on	déposer sur
drop on by your neighborhood	passe dans ton quartier
drop on by your neighborhood item shop	rendez-vous dans votre magasin d'articles de quartier
drown	noyer
drowsy	somnolent
du pain	bread
duck	canard
duggery	duperie
dump	décharger
duty	devoir/droit/obligation/service
dwell	habiter/demeurer
eager	désireux
eavesdropp	écouter de façon indiscrète
edible	comestible
either way	dans les deux cas
embed	intégrer
embittered	Aigris
embody	incarner
emphasize	souligner
end to end	de bout en bout
endorse it	l'aprouver/le valider
engulf	engloutir
enjoy	profitez
enjoy	profitez/apprécier
enjoy yourself	Amusez-vous bien
enshrine	conserver précieusement
ensues	s'ensuit
entrust	confier
entrusted	confié
even so	Toutefois
even so	malgré toutefois/tout/néanmoins
evenly	uniformément/également
every so often	de temps en temps
evil	mauvais
executioners	bourreaux
expect	attendre/espérer
expel	expulser
eyelid	paupière
eyesore	horreur
fade	disparaître
fade up	s'estomper
faint	faible/léger/s'évanouir
faint	perdre connaissance
fair share	partage équitable
falcon	faucon
fall	tombe
fall	tomber
fallen	déchu
falling apart	s'effondrer
fang	croc
farewell	adieu
feast	festin
feature	caractéristiques
feel at ease	sentir à l'aise
feel at home	se sentir à la maison
feel right at home	se sentir comme chez soi
fell	tomba/abattre
fellow	collègue/compagnon
fence post	poteau de clôture
few	quelques/peu
fewer	moins/moins de
fierce	féroce
file off	limer
fill you in on	vous renseigner sur
fine-tuned	peaufiné
fire hydrant	bouche d'incendie
fire up	gonflé à bloc/allumer
fired up	gonflé à bloc/excité
first sight	première vue
first-floor room	salle au premier étage
fit	en forme
fitting punishment	punition appropriée
flag	drapeau/étendard/signaler
flatten	aplatir
flawed	défectueux
flawess	sans défaut
flee	fuir
fling flung flung	jeter/lancer/projeter/aventure
flow	couler
flowing air	air qui coule
flung	jeté
fly out	envoler
fogged	embué/confus
folk	gens/peuple
folks	gens
fond	aimer/adorer/affectueux/tendre
fondness	penchant
food and whatnot	nourriture et autres
fooling me	me tromper
for I	car je
for all i care	pour tout ce qui m'importe
for assessing	pour évaluer
for naught	pour rien
for parts	pour pièces
for starters	pour commencer/pour les debutants
for the sake of	Pour l'amour de
forbidden	interdit/défendu
force of will	force de volonté
foreboding	pressentiment
foreign	étranger
foremost	avant toute chose
foresee	prévoir
formal	formel/officiel
foul	faute
found his calling	a trouvé sa vocation
free will	libre arbitre/liberté d'expression
freebie	billet de faveur
freed	libéré
from afar	de loin
from here	à partir d'ici
from here on out	à partir de maintenant
from scratch	de zéro
fruitions	réalisation/jouissance
further	plus loin
fuss	histoire/agitation/agiter
gale	coup de vent/grand vent
galesong	chant des vents
gather	rassembler
gathering	la cueillette
gaze	regard/regarder
gazes	regards
geared	adapté
geared up	Paré
geezer	mec/viellard
gentle	doux/gentil
get along	s'entendre
get down to	passer à/descendre à
get enough	en avoir assez
get his act together	se ressaisir
get out	Sortez
get tighter	se resserrer
get to see	réussir à voir/chance de voir
get up	se lever
get your hopes up	s'emballer
gig	concert
gimmicks	gadgets
gist	essentiel
given	donné/accordé/étant donné
given you	étant donné que tu
glamorous	glamour
glance	coup d'œil
glum	maussade
gonna	going to
goods	des biens
goods	marchandises/biens
gorge	gorge/engouffrer
got every last one too	j'ai eu le dernier aussi
got into the store	est entré dans le magasin
got rid of thoses	débarrassé de ceux-là
gotta	got to/have to
grab	saisir
graduate internship	Stage de fin d'études
grasp	saisir/comprendre
grasping	saisir
grave	grave/sérieux
gray's emotional strength trumped Rufus's.	La force émotionnelle de Gray l'emportait sur celle de Rufus.
greenhorn	jeunot
grief	douleur
grudge	rancune
gut	intestin/instinct/tripes
ham	jambon
handcuffs	menott
handle	manipuler
handover	transfert
handwriting	écriture
hang	pendre
hang around	traîner
hang in	accrocher dans
hang in a balance	est en équilibre
hang in the balance	est en jeu
hang on	résister/attendre
hanging	suspendu
happenstance	hasard/hasardeux
hard boiled	dur à cuire
harm	préjudice
harness	exploiter
harness its energy	exploiter son énergie
has seen many a moon	a vu plus d'une lune
has to lift the owner's spirit	doit remonter le moral du propriétaire
hatch	trappe
hatred	haine
hats off	chapeau/chapeau bas/bravo
haul	transport/butin/transporter
have it your way	fait comme tu veux
have it your way	faites comme vous voulez
have made	ont fait
have made themself	se sont fait
have made themself at home	se sont fait comme chez eux/Se sont installés confortablement.
hawk	faucon
haystack	botte de foin
he could	il pourrait
he lured	il a attiré
he nicked it	il l'a piqué
he parted	il s'est séparé
he takes it upon himself	il prend sur lui
he takes it upon himself to go	il se charge d'aller
head	tête/chef/diriger
head back	la tête en arrière
head down	tête baissée
head off	partir
head on to	dirigez-vous vers
head up	tête haute
head up	tête haute/diriger vers le haut
headband	Bandeau
heartache	chagrin
heartstoppers	coups de cœur
heated up	réchauffé
heavenly	céleste
hedgehog	hérisson
heed	tenir compte/écouter
helping hand	Coup de main
helpless look	regard impuissant
hence	Par conséquent
hence	Par conséquent/ainsi
hidden	caché
hideous	hideux/affreux
hill	colline
hinder	entraver
hindmost	le plus en arrière
hindrance	obstacle/entrave/frein
hinge on	dépen de
hinge upon	reposer sur
his cries	ses pleurs
his share of	sa part de
his skin turned to scales	sa peau s'est transformée en écailles
hissing	sifflant
hold of	main sur/emparer de
hold out	résistant
hold you to that	tenez-vous à cela
hoodlum	voyou
hop	saut
horn	corne/klaxon
hosepipe	tuyau d'arrosage
hot springs	sources chaudes
hotel	hôtel
hotshot	champion/successful person
hotshot	crâneur
how did it feel	comment vous êtes-vous senti
how it's done	comment c'est fait
how's about you and me get a room and play pin the tail feather on the chocobo	Et si vous et moi prenions une chambre et jouions à épingler la plume de la queue sur le chocobo
however, underneath all that	cependant, en dessous de tout cela
hum	bourdonnement/fredonner/chantonner
i awoke	je me suis réveillé
i been meaning to ask	je voulais demander
i can't picture	je ne peux pas imaginer
i concur	Je suis d'accord
i don't want to get your hopes up	Je ne veux pas te faire de faux espoirs
i dug	j'ai creusé
i dug them out	je les ai déterrés
i fouled	j'ai commis une faute
i fouled things up	j'ai gâché les choses
i have been told	On m'a dit
i held	j'ai tenu
i held onto them	je les ai retenus
i hold onto them	je les retiens
i intend	je prévois
i just happen to be	je viens juste d'être
i meant to atone	je voulais expier
i owe you	je vous dois
i pay more attention	je fais plus attention
i recall	je rappelle
i recall with	je me souviens avec
i recall with crystal clarity	je me souviens avec une clarté cristalline
i shall	je vais
i switch out	je change
i want them to stay on it	je veux qu'ils restent dessus
i was on duty	j'étais de service
i would like you to	J'aimerais que tu
i'll bear	je supporterai
i'll bear witness	je témoignerai
i'll fill you in later	je vous renseignerai plus tard
i'll handle	je vais gérer
i'll handle it	je vais m'en occuper
i'll head on down	je vais descendre
i'll lend a hand	je vais donner un coup de main
i'll manage	Je me débrouillerai
i'll nab	je vais choper
i'm all set	je suis prêt
if you don't look out for yourself, no one else will	si vous ne faites pas attention à vous-même, personne d'autre ne le fera
in a bit	dans un petit instant
in a huge crush	dans un énorme béguin
in a hurry	pressé
in a place	dans un endroit
in a place this dark	dans un endroit aussi sombre
in any case	dans tout les cas
in charge of collections	en charge des recouvrements
in days	en jours
in every way	de toutes les manières
in half	à moitié
in the break room roof	sur le toit de la salle de repos
in the nick of time	juste à temps
in what ways	used when the available options or possibilities are not predefined or known
in which case	dans quel cas
in which ways	used when the available options or possibilities are already known or limited
incapacitate	rendre incapable de faire qch/neutraliser/immobilier
incapacitated	incompétent/incapable
incentive	incitation/encouragement
infuriat	furieux
inhabitant	habitant
inlaid	incrusté
inner	intérieur
innocuous	inoffensif/anodin
instill	insuffler
into	dans
into them	en eux
is a chore	est une corvée
is fond	 aime
it flow like wind	ça coule comme le vent
it grieves me	ça me chagrine
it had gotten	il était devenu
it happen to be	il se trouve que
it is still daylight	il fait encore jour
it seems	il semble
it will sputter out	ça va crachoter
it wouldn't rather be	ça ne serait pas plutôt
it's a pity	c'est dommage
it's all hope	tout n'est qu'espoir
it's been over 10 years	ca fait plus de 10 ans
it's not dark	il ne fait pas nuit
it's still clinging	ça colle encore
it's still clinging to me	ça me colle encore
jamming	brouillage
jersey	maillot
journey	voyage/voyager
just has to lift	n'a qu'à soulever
keen	enthousiaste/vif
keep at	poursuivre
keep at it	persévère
keep it up	continuez comme ça
keep shut	rester fermé
keeping their wits	garder la tête froide
kettle	bouilloire
kin	proche
kindly	gentiment
knack	talent/don
lair	repaire
lamp post	lampadaire
lately	dernièrement
laugh it up	riez-en
laugh it up for all i care	rire pour tout ce qui m'importe
layout	disposition
lead on	conduire
leap of faith	the act of believing in or accepting something outside the boundaries of reason
leave him be	laisse-le tranquille
lend	prêter
lesson for life	leçon de vie
let alone work with it	encore moins travailler avec
let's get going	allons-y
let's get this over with	finissons-en avec
let's go check in	allons vérifier
let's hang in	accrochons-nous
let's head back	rentrons
let's head up	dirigeons-nous vers
let's head up top	montons en haut
let's hop	sautons
let's hop to it	allons-y
let's wrap this	terminons ça
lie in wait	guetter/à l'affût
life is fleeting	la vie est éphémère
lifted	lever/soulever
lifted	levé
lighthouse	phare
likelihood	probabilité/vraisemblance
likely	probable
limbs	membres
limbs scattered	membres éparpillés
lineage	lignée
listen to me/hear me out	écoutez-moi
little chat	petite conversation
lively	animée
lively	vif/animé/vivant
loathe	détester/haïr
loathe me	me déteste
lone	seul
lone stand	solitaire
long way	long chemin
look down	baisser les yeux
look down their noses at us	nous regarde de haut
look for another means	chercher un autre moyen
looking for	à la recherche de
lookout	guetteur/post de guet
loom	métier a tisser/se profiler
lose out	être perdant
love at first sight	le coup de foudre
luggage	bagage
lung	poumon
lure	leurre
lurk	se cacher
lying	mensonge
lying down	allongé
lying over	allongé sur
made of	fait de
made one hell	fait un enfer
made one hell of a mess	fait un sacré gâchis
make it a habit	en faire une habitude
make up for	compenser
make up for lost time	rattraper le temps perdu
make up for them	les rattraper
mankind	humanité/Homme
many a	beaucoup de
master	maître/maîtriser
mean meant meant	signifier/vouloir dire
meaningless	sans signification
meantime	entre temps
melt	fondre
melted	fondu
melting	fusion
merely	simplement/seulement
mess	désordre
mess	désordre/gâchis
messing with	de jouer avec
messing with	de jouer avec/embêter
might be	pourrait être
mischief	sottises
molding	moulage
mole	taupe
monitoring	surveillance
more like	plus comme
more lively	plus vif
mosey up	se lever
much obliged	Infiniment reconnaissant
mug	mug/tasse
mutter	marmonner/murmurer
muttering	marmonner
my bare hands	mes mains nues
my fair share	ma juste part
my guibea pig	mon cochon d'inde
my guinea pig	mon cochon d'inde
my own will	ma propre volonté
my regards	mes salutations
my regulars	mes habitués
nab	attraper/choper
narrow	étroit
neatly	soigneusement
needle	aiguille
needless	inutile
neighborhood	quartier
nest	nid
nesting	imbrication
newfound	recement decouvert
news this good	des nouvelles aussi bonnes
nike brand goods	produits de la marque nike
nimble	agile
no part in undermining	aucune part dans l'affaiblissement
not to worry	ne pas s'inquiéter
nothing but trash	rien que des ordures
notice	remarquer
oath	serment
odd	étrange
odd behaviour	comportement étrange
odd job	petit boulot
odd jobs	petit boulots
of a mess	d'un gâchis
of its kind	de son genre
of the people's	du peuple
of wonder	d'émerveillement
off-limits/prohibited	interdit
ominous	sinistre
on behalf	de la part de
on down	vers le bas
on my behalf	en mon nom
on our way	sur notre chemin
on out	sur
on the bound	sur le fil
on the ground floor	au rez-de-chaussée
on to	sur
on up to	sur un maximum de
once we meet	une fois que nous nous rencontrons
once you get into it	une fois qu'on se jette dedans
one must	Il faut/On doit
onto	sur/dans/vers
onto them	sur eux
or else	ou sinon
orchard	verger
otherwise	Par ailleurs
out in open	dehors/en plein air
out of	par/hors de/en dehors de
out of curiosity	par curiosité
outlander	étranger
outlanders	étrangers
outrider	cavalier
outweigh	emporter sur
outweigh	emporter sur/dépasser
over	sur/plus de /plus/pendant/au-dessus/terminé/fini
over at	a
over at the pillar	au pilier
overcome it	le surmonter
overfitting	sur-ajustement
overrun	envahie
oversee	superviser
overthrown	renversé
owe	devoir
owing to	en raison de
owing to the special outcome	en raison du résultat spécial
package	colis/paquet
pad your	remplir votre
pan	poêle
parcel	parcelle/colis
part	partie/séparer/participé
partings	séparations
pass up	laisser passer
past and gone	passé et disparu
peanut butter	beurre de cacahuète
pedestrian	piéton
pedestrian crossing	passage pieton
per se	en soi
perhaps	peut-être/sans doute
perish	périr
personal matters	affaires personnelles
pertains	se rapporte
pile up	entasser
pinpointed	identifié
pitiful	pitoyable
place	lieu/place/endroit/placer/passer
plight	situation critique
plight	situation critique
plot	terrain/parcelle/intrigue/tracer/comploter
plums	prunes
point	indiquer/pointe
poise	équilibre/calme
poke around	fouiller
policy	politique
post	poste/article/billet/message/poteau/publication/poster/publier
pour	verser
praises	louanges
predicament	situation difficile
presently	présentement/actuellement
pressured	sous pression
pretty bare	assez nu
preventing	empêcher
proceeding	procéder
profitable	rentable
prosperous	prospère
public transport	transports en commun
pull her under	la faire sombrer
pushovers	des jeux d'enfant
pushy	arrogant
put it away	ranger
put on a	mettre sur un/mettre un
put out	éteindre
putting off maintenance	remettre à plus tard l'entretien
putting up	mettre en place
racking	rayonnage
racking your brain	se creusant la cervelle
raise a child	élever un enfant
rashly	imprudemment
rather unique developments	développements plutôt uniques
rattraper son retard	catch up
readily	facilement
realm	royaume/domaine
reckon	compter/estimer
reckoning	compte
record	enregistrement/dossier/enregistrer
red-handed	en flagrant délit
reef	récif
refresher	remise à niveau
rejoice	réjouir
reminiscent	rappelant
repel	repel
resemble	ressembler
resort	station/recourir/
resurgence	réapparition
rev up	accéléré
revere	vénérer
revved up	accéléré
riches	richesse
rid	débarrasser
rid of you	débarrassé de toi
riddles	énigmes
rile	agacer/énerver
riled up	s'énerver
rise	monter/lever/hausse/augmentation
rise rose rosen	augmenter/s'élever
roof	toit
rope	corde
rot down there	pourrir là-bas
rotten egg	œuf pourri
rotten egg smell	odeur d'œuf pourri
rough	rude/brutal
rough	rugueux/rude
roughing him	le brutaliser
roughing him up	le malmener
ruckus	chahut
run along now	courir maintenant
run amok	se déchaîner
run down	délabré/vétuste/descendre/dénigrer
rustle up	se débrouiller pour trouver
safe and sound	sain et sauf
sail	voile/navigation/naviguer
salesman	vendeur
salvage	sauvetage
scatter	éparpiller/disperser
scattered	dispersée
scattered	éparpillés/dispersée
scent	parfum
scholar	érudit/savant
scolding	réprimande
scrambling	brouillage
scrap	ferraille
scratch	rayure/égratignure/gratter/rayer
screw this	J'en ai rien à faire
screw you	va te faire voir
scuffle	marcher en traînant les pieds/se bagarrer
seal	sceller
seamlessly	de façon transparente
seat post	tige de selle
seeing	voyant
seeing as	voyant comme
seek sought sought	chercher
seem	sembler
seemingly	apparemment
seize	saisir
serial numbers filed off	numéros de série classés
serial numbers filed off	numéros de série effacés
settle	régler/s'installer
settle	s'installer
settle for	se contenter de
settle up	régler
settle your bill	régler votre facture
settling	règlement
sew	coudre
shabbily	minablement
shamble	marcher en traînant les pieds
shambles	pagaille
shatter	briser
she disappeared	elle a disparu
she fainted	elle s'est évanouie
she sure sounds like it	elle y ressemble bien
she went missing	elle a disparu
shed tears	verser des larmes/pleurer
shelves	des étagères
shipments	expéditions/délivraisons
shirt	chemise
short-tempered	colérique
shorthanded	à court de main-d'œuvre
shout	crier
shrimp	crevette
siblings	freres et soeurs
sidetrack	distraire/détourner
sight	vue/aperçu
sightings	observations
sights	curiosités/attractions
sign	signe/pancarte/panneau/signer/connecter
simmer down	s'apaiser
simply put	tout simplement/pour vous donnez une idée
sinful	coupage/pécheur
sing sang sung	chanter
skeletal	squelettique
skeptical	sceptique
skewer	brochette
skirt	jupe
sleek	lisse/élégant
slimy	visqueux/gluant
slip out	glisser
slumber	sommeil
smooth	lisse/doux
snatch	arracher/saisir
snot	morve
soar	envol/s'envoler
soar	s'envoler/s'élever/planer
solely	uniquement
solid gold	or massif
somehow	en quelque sorte/d'une certaine manière/d'une certaine façon
something is off	quelque chose ne va pas
somewhat	quelque peu
soothe	apaiser
sorely	grandement
sorrow	chagrin/tristess
spare	de rechange
sparse	Clairsemé
speaking of which	en parlant de ça/d'ailleurs
spilling	effusion
spine	colonne vertébrale
spit it	crache le
spit it out	crache le morceau
spout	jailli/débiter
sprang	jailli/bondit
sprawl	expansion/s'étendre
sprawling	tentaculaire
spring	le printemps
sputter out	crachoter
squeak	grincer
squeaking	grincement
squeeze	presser/écraser
stab	poignarder/planter
stagger	tribucher/tituber
stamp is the one who will get the job done	le timbre est celui qui fera le travail
stand	se lever/se tenir debout
stand down	démissionner/se retirer
stand for	représenter/défendre
stand in our way	nous barrer la route
stare	Regard
starfell	étoile tombante/étoilé
starfell	étoilé
started back up	recommencé
stash	planque/réserve
steep	raide
steer clear	evitez
stepped up	intensifié
stick around	rester dans les parages
stifling	étouffant
stir	remuer
stirring up	remuant
stirring up trouble	semer le trouble
stock goods	marchandises en stock
stopwatch	chronometre
stopwatch	chronomètre
straight away	tout de suite
stray	errer
streamline	rationaliser
street light	éclairage public
strip	bande/dépouiller
strip	déshabiller
strip this thing	dépouiller cette chose
strip this thing for parts	dépouiller cette chose pour les pièces
strive	aspirer/s'éfforcer/lutter
strive	efforcer
strolling up to us	flâner jusqu'à nous
struck	frappé
strum	gratter
stumbled	trébuché
stumbled across	tombé sur
sturdy plank	planche solide
subdue	maîtriser/dominer
suburb	banlieue
suddenly	soudain
summer	été
sunbeam	rayon de soleil
suppliers	fournisseurs
supplies	Provisions/fournitures
surely	sûrement/certainement
sustainer	soutien
swan	cygne
sweat	sueur/transpiration/transpirer/suer
swell swoll	gonflé
swiftly	rapidement
tackle	s'attaquer à
tackle	s'attaquer à/aborder
tackling	s'attaquer
take a gander	jetez un coup d'oeil
take a stroll down	faire une promenade
take care those things	prends soin de ces choses
take over	reprendre
taken over	repris
talk you later	te parler plus tard
talk you up to	parler de toi
tapis	carpet
tear down	démolir/détruire
tearing up	déchirer
tearing up town	déchirer la ville
tedious talk	conversation fastidieuse
tell me	dites moi/raconte moi
temper	tempérament
that blossoms	qui fleurit
that i do	Ce que je fais
that might jog your memory	ça pourrait te rafraîchir la mémoire
that wander into town	qui errent en ville
that went well	ça s'est bien passé
that which you	ce que tu
that which you will experience	ce que tu vivras
the Diluc's say-so	les paroles de Diluc
the best bargains yet	les meilleures affaires à ce jour
the best that I could afford was a first-floor room	le mieux que je pouvais me permettre était une chambre au premier étage
the bigger critters	les plus grosses bestioles
the bond	le lien
the bride	la mariée
the brilliantly avenged	le brillamment vengé
the bulk	l'essentiel
the burden	la charge/le fardeau
the chatter	le bavardage
the chosen	l'élu
the dare	L'audace
the day after tomorrow	le surlendemain
the goods	les biens/la marchanfise
the grand tour	la grande tournée
the guts	les tripes
the heavens	Le Paradis/ les cieux
the heir	l'héritier
the itch	la démangeaison
the item store's fallen on hard time	le magasin d'articles est tombé en difficulté
the latter solution	cette dernière solution
the least I can	le moins que je puisse
the least bit	le moins du monde
the ley lines	les lignes telluriques
the opposite of	le contraire de
the outskirt	la périphérie
the plus side	le côté positif
the remains	les restes
the remains at rest	les restes au repos
the robbery	Le vol/pillage
the sigh of a sinner	le soupir d'un pécheur
the slums	les bidonvilles
the so-called	la dite
the sparsity	la rareté/something being sparse, scarce, or not densely populated
the sword sheathed	l'épée rengainée
the tail feather	la plume de la queue
the tally	le décompte
the tide's turned in our favor	le vent a tourné en notre faveur
the tides	Les marées
the ties	les liens
the time being	le moment
the vacant lot	le terrain vacant
the very idea	l'idée même
the very idea sends tingles	l'idée même envoie des picotements
the very idea sends tingles down my spine	l'idée même envoie des picotements dans le dos
the whole	la totalité
their envoys	leurs envoyés
their kin	leurs proches
their mind has made up	leur décision est prise
their noses at us	leur nez sur nous
there first thing tomorrow	demain à la première heure
thereby	ainsi
therefore	donc/par conséquant
therefore	donw
they are nesting	ils nichent
they are not monitoring us	ils ne nous surveillent pas
they don't look anything like knights	ils ne ressemblent en rien à des chevaliers
they don't take kindly to questions	ils ne prennent pas gentiment les questions
they have almost	ils ont presque
they must have made off	ils ont dû s'enfuir
they worship	ils vénèrent
think thought thought	penser
thinned	aminci
thinned out	aminci
thirst	la soif
this might be	cela pourrait être
this wouldn't have happened	cela ne serait pas arrivé
thorough	approfondi
thorough	complet
thorough notes	des notes détaillées
though	bien que/mais/même si/cependant/pourtant
thought	pensé
thoughtful	réfléchi
threatened	menacé
thrive	s'épanouir/prospérer
thriving	prospère
through a lot	à travers beaucoup
throughout	tout au long de
thrust	poussée
thrusting my chest out	bomber ma poitrine
thus	ainsi
tide	marée
tidily	proprement
tidy	bien rangé
tidy them up	les ranger
tie	cravate/lien/égalité/attache/attacher/lier/nouer
tied up	attaché
tin	étain
to balls everything up	pour tout bouleverser
to be led	d'être dirigée/d'être conduit
to be lying in wait	être à l'affût
to be passing by	être de passage
to behold	a voir
to channel	pour canaliser
to close up	fermer
to con you	de vous escroquer
to devise	concevoir
to fall completely flat	tomber complètement à plat
to fill	remplir
to fill in	remplir
to gather their kin	rassembler leurs proches
to get off on the right foot	repartir du bon pied
to get your story straight	pour mettre votre histoire au clair
to good use	à bon escient
to grasp	saisir
to make of it	en faire/en penser
to make up for it	Pour compenser/pour se rattraper
to melt you	pour te faire fondre
to monitor	surveiller
to right the	réparer/redresser
to shape up	se mettre en forme
to shrink	rétrécir
to sing along	chanter a ses cotés
to spare	épargner
to stock up	s'approvisionner
to strut	se pavaner
to tears	aux larmes
to the higher ups	aux plus hauts gradés
to the will	à la volonté
to tie up all loose ends	régler tous les problèmes
to undermine	amoindrir
to what do we owe	à quoi devons-nous
to what do we owe the honor today	à quoi devons-nous l'honneur aujourd'hui
to whip up	attiser/fouetter
told yourself	parle pour toi même
topsiders	les supérieurs
tore	déchiré
tore up	déchiré
touch base	base tactile
traffic jam	embouteillage/bouchon
traffic light	feu tricolor/feu de circulation
trail	piste/sentier/chemin
trailblazer	pionnier
trainees	stagiaires
transient	transitoire
transpire	transpirer/apparaître/se produire
transpired in days	s'est passé en jours
treat you	te traiter
trembling	tremblante
tremors	tremblements
tried and true lesson	leçon éprouvée
trifle	broutille/trivial/bagatelles/chose sans importance
trounced	battue
trumped	devancé/dépassé/surclassé
trust	confiance
trust me to find	fais moi confiance pour trouver
twisting and twining itself	se tordant et s'enroulant
twitching	contractions/tremblement
twitching eye	œil qui tremble
underhanded	sournois
underlying	sous-jacent
underneath all that	en dessous de tout ça
uneasy	inquiet/préoccupé/anxieux
unfold	se dérouler/déplier
unlike	contrairement à
unsavory	peu recommandable
unwind	se détendre
up her mind	sa décision
up there	là-haut/là-bas
up to	jusqu'à
up to it	jusqu'à ça/à la hauteur
upon	sur/après/selon/au moment
upon checking	après vérification
upon checking	après vérificationI'd always wanted to be in Sabertooth,
upon me	sur moi
useful later	utile plus tard
useful later down the line	utile plus tard sur toute la ligne
vale	vallée
valley	vallée
vanish	disparaître
vegetable patch	potager
vile	vil/ignoble/horrible/nauséabond
vow	vœu
vow	vœu/jurer
wag	remuer
waiter	serveur
wallow	vautrer/complaire
wander	errer
wander	errer/promener/balade
wanderer	vagabond
wandering around	errant autour
ward	quartier/pupille/service (hopitale)
warehouse	entrepôt
was but	n'était que
watchman	gardien/veilleur/guetteur
watermelon	pasteque
we are off to	nous partons pour
we have been through	nous avons traversé
we have been through a lot	nous avons vécu beaucoup de choses
we have got them on the ropes	~?nous les avons sur les cordes
we just happen to be	il se trouve que nous sommes
we pile up	on empile
we planned	nous avons prévu
we shall	nous allons
we shall journey	nous voyagerons
we will lose out	nous allons y perdre
we wouldn't	nous ne ferions pas
weak-willed	faible de volonté
wearing	porter
went sour	a mal tourné
were sights to behold	étaient des sites à voir
what a klutz	quel maladroit
what a relief	quel soulagement
what are you agonizing over	de quoi souffrez-vous
what are you suffering from	de quoi souffrez-vous
what do you make of it	Qu'est-ce que vous en faites
what does he sell	qu'est-ce qu'il vend
what is to be sung	ce qui doit être chanté
what lies ahead	ce qui nous attend
what the hell went down at	qu'est-ce qui s'est passé chez
what's got into John	qu'est-ce qui cloche chez John
where is he	où est-il
whereas	tandis que
whether	qu'il s'agisse
whether	si/que/qu'il s'agisse
whether the trees	si les arbres
whether to go	s'il faut aller
which is why	c'est pourquoi
which leads to	qui mène à
whirl	tourbillon/tourbilloner
whistling	sifflant
who can't	qui ne peut pas
who can't get	qui ne peut pas obtenir
who can't get to	qui ne peut pas se rendre
who can't get to work	qui ne peut pas se rendre au travail
who can't get to work up	qui ne peut pas se mettre au travail
who can't get to work up top	qui ne peut pas travailler en haut
who's not as strong as whom ?	qui n'est pas aussi fort que qui ?
whole	tout/ensemble/totality/entier/complet-
whuppin	coup de fouet
why bother putting	pourquoi s'embêter à mettre
why bother putting them outside	pourquoi s'embêter à les mettre dehors
why would the likes of a cat	pourquoi les goûts d'un chat
wicked	malfaisant/mauvais/méchant
wide selection	large selection
widely	largement
widens	s'élargit
widespread	généralité/répendu
widespread	répandu
widest possible	plus vaste possible
wield	manier
wielder	porteur
wild mountain fruit	fruits sauvages des montagnes
wilderness	région sauvage
will	volonté
will be pleased	se fera un plaisir
willing	prêt
wind currents	courants de vent
windborne	porté par le vent
windwail	gémissement
winery	vignoble
wink	clin d'oeil
winter	hiver
wipe out	anéantir/effacé
wisdom	sagesse
wisecrack	remarque
wit	esprit
wither	faner/dépérir
within	dans/à l'intérieur
without any worry	sans le moindre soucie
witness	témoin
witness	témoin/témoignage/témoigner
witnesses	les témoins
woe	malheur
wonder	se demander/Émerveillement
wonders	merveilles
wondrous	merveilleuse
wondrous	merveilleux
worn out	usé
worship	culte
worthwhile	digne d'interêt
worthy	digne
worthy of notice	digne d'attention
would	serait/pourrait/ferait/devrait/voudrait
would have	aurait
wound	plaie/blessure/enrouler
wounded	blessés
woven	tissé
wrap	envelopper
wrath	colère
x and whatnot	x et d'autre chose similaire
yarn ball	pelote de laine
yearn	aspirer
yell	crier
yet	encore/pourtant
yogurt pots	les pots de yaourt
yore	autrefois/d'antan/jadis
you are grounded	tu es puni
you can do it	vous pouvez le faire
you could do it	vous pourriez le faire
you deem fit	vous jugez bon
you do end up	tu finis par
you don't look the type	tu n'as pas l'air du genre
you had a bout	tu as eu un combat
you harbor	tu abrites
you hate sour food	vous détestez la nourriture aigre
you have nothing to apologize for	tu n'as rien à te reprocher
you lack	tu manques
you of all people	toi de tous
you shoot your mouths off about how strong you are on a regular basis, don't you ?	Vous vous moquez régulièrement de votre force, n'est-ce pas ?
you tie	tu attaches
you tied	tu as attaché
you will assist me in	vous m'aiderez à
you will not wallow in grief and remorse	tu ne te complaîtras pas dans le chagrin et les remords
you won't witness	tu ne seras pas témoin
your calling	ta vocation
your fall	ta chute
your partner is in a pinch	votre partenaire est dans le pétrin
your way	votre chemin
your while	votre temps
yourself	toi même
yourselves out	sortez
être bridé	to be restrained
